||                          ||
||                          ||
||                          ||
||                          ||
||                          ||
||           ____           ||
||         .''''''.         ||
||        /   __   \        ||
||\__..-':   /\/\   :'-..__/||
||=__ =|='  |-()-|  '=|= __=||
||/  ''-.:   \/\/   :.-''  \||
||        \   ""   /        ||
||         `.____.'         ||
||                          ||
||                          ||
||                          ||
||                          ||
||                          ||
||                          ||
